.,.,.,s,.,x,.,.,.,.,.,.
.,.,.,v,.,^,.,.,.,.,.,.
.,.,.,v,.,^,.,.,.,.,.,.
.,.,.,v,.,^,.,.,.,.,.,.
x,<,<,+,<,+,<,<,<,<,<,s
.,.,.,v,.,^,.,.,.,.,.,.
s,>,>,+,>,+,>,>,>,>,>,x
.,.,.,v,.,^,.,.,.,.,.,.
.,.,.,v,.,^,.,.,.,.,.,.
.,.,.,v,.,^,.,.,.,.,.,.
.,.,.,v,.,^,.,.,.,.,.,.
.,.,.,v,.,^,.,.,.,.,.,.
.,.,.,x,.,s,.,.,.,.,.,.
.,.,.,.,.,.,.,.,.,.,.,.
.,.,.,.,.,.,.,.,.,.,.,.
