.,.,.,x,.,.,.,.,.,x,.,.
.,.,.,^,.,.,.,.,.,^,.,.
.,.,.,^,.,.,.,.,.,^,.,.
.,.,.,^,.,.,.,.,.,^,.,.
s,>,>,+,>,>,>,>,>,+,>,x
.,.,.,^,.,.,.,.,.,.,.,.
.,.,.,^,.,.,.,.,.,.,.,.
.,.,.,^,.,.,.,.,.,.,.,.
.,.,.,^,.,.,.,.,.,.,.,.
.,.,.,^,.,.,.,.,.,.,.,.
.,.,.,s,.,.,.,.,.,.,.,.
.,.,.,.,.,.,.,.,.,.,.,.
.,.,.,.,.,.,.,.,.,.,.,.
